TTTTTTTTTTTTTTTTTTTTTTTTTTTTTTTTTTTTTTTTTTTTTTTTT
TTT............TTTT.TTT...TTTT.TTTT............TT
TT.............TTT........TTT..TTT.............TT
T...............................................T
T...............................O...............T
T...............................O...............T
T...............................O...............T
T.......................TT......O...............T
T......................TTT......O...............T
T......................TTT......O...............T
T...............................O...............T
T...............................O...............T
T...............................O...............T
T...............................O...............T
T.............................OOO...............T
TTT............TTTT...........OTTTT............TT
TTT............TTTT...........OTTTT............TT
TTT............TTTT...........OTTTT............TT
TT.............TTT............OTTT.............TT
TT............................O.................T
TT............................O.................T
TT............................O.................T
TT............................O.................T
T.............................O.................T
T.............................O.................T
T.............................O.................T
TT............................O.................T
TTT...........................O.................T
TTT...........................O.................T
TTT...........................O.................T
T.............................O.................T
TTT............TTTT...........OTTTT............TT
TTT............TTTT...........OTTTT............TT
TTT............TTTT...........OTTTT............TT
TT.............TTT............OTTT.............TT
T.............................O.................T
T............................OO.................T
T...........................OO..................T
T..........................OO...................T
T.........................OO....................T
T........................OO.....................T
T.......................OO......................T
T......................OO.......................T
T.....................OO........................T
T....................OO.........................T
T..................OOO..........................T
T..................OTTT...TTT...................T
TTT............TTTTOTTTT..TTTT.TTTT............TT
TTTTTTTTTTTTTTTTTTTTTTTTTTTTTTTTTTTTTTTTTTTTTTTTT
